12
20
64
64
....................
....F.F......123....
....123.EE.........G
.....EE.123.......13
13..123......123....
........K...........
P........123...FF...
......2........12223
1223................
.........123........
....................
12222222222222222223