12
20
64
64
....E...E...........
....12223...........
G.......13..E..E....
13..........1223....
......E...E......K13
.P....12223.........
..............13....
1223................
.......123..........
.............123....
....F...F..........K
12222222222222222223