15
20
41
....................
....................
....................
.......5555555......
......11w111w11.....
.....4h444h444h4....
.....333w333w333....
.......22www22......
........22h22.......
....................
....................
....................
....................
....................
....................