6
8
24
123  321
12    21
1      1
1      1
12    21
123  321