15
20
32
11122111............
22233222............
.334433.............
.445544.............
55555555............
hwhwhwhw............
....................
....................
....................
....................
....................
....................
....................
....................
....................