15
20
40
12345123............
12345123............
.44..11.............
.55..22.............
54321543............
54321543............
....................
....................
....................
....................
....................
....................
....................
....................
....................