15
20
32
...22111............
...33222............
...4433.............
...5544.............
55555555............
hwhwh.hw............
....................
....................
.h..................
h.wh................
....................
....................
.....5..............
.w..................
.h..................