12
20
64
64
....................
61111111181111111111
2........2..........
4118111119..........
...2.....2..........
...2.....2..........
6113.....011115.6115
2.......63....413..2
411118113..........2
.....2........6115.2
.....0111111113..413
111113..............