12
20
64
64
XXXXXXXXXSOXXXXXXXXX
XXXXXXXXXXXXXXXXXXXX
XXXXOXXXXXXXXXXXXXXX
XXXXXXXXXXOXXXXXXOXX
XXXXXXOXXXXXXXXXXXXX
XOXXXXXXXXXXOXXXXXXX
XXXXXXXXXXXXXXXXXXXX
XXXXXXXXOXXXXXXXXXXX
XXXXXXXXXXXXXXXOXXXX
XOXXXXXXXXXXOXXXXXXX
EXXXXXXXXXXXXXXXXXXX
XXXXXXXOXXXXXXXXXXXX