12
20
64
64
....................
61111181111111118111
2.....2.........2...
411811A1115.....2...
...2..2...4111113...
...2..2.............
6113..411111115.6115
2.............413..2
411115.............2
.....2........6115.2
.....0111111113..413
111113..............