12
20
64
64
.........2..........
...61111171115......
...2.........411115.
...4811115........2.
....2....0811111113.
....41811A3.........
615...2..481115.....
2.41113...2...2.....
41111111119...2.....
..........2...2.....
111111111171113.....
....................