12
20
64
64
XXXXXXXXOXXXXXXXXXXX
XXXXXXXXXXXXXXXXXXXS
XOXXXXXXXXXXXXXOXXXX
XXXXXXXXXXXXXXXXXXXX
XXXXXXXXXXXXXXXXXXXX
XXOXXXXXOXXXXXXXXOXX
XXXXXXXXXXXXXXXXXXXX
XOXXXXXXXXXXXXXXXXXX
XXXXXXXXXXXXXXXXXXOX
XXXXXXXXXXOXXXXXXXXX
XXXOXXXXXXXXXXXXOXXX
EXXXXXXXXXXXXXXXXXXX