12
20
64
64
..2.................
613...611111111115..
2.....2..........2..
4111113..........2..
...611111111111152..
...2............43..
...2.6111111115.....
...2.2........2.....
...413........2.....
..............415...
................2...
................4111