12
20
64
64
XXXXXXXXXOOOOOOOOXXX
XXXXXXXXXXXXXXXXOXXX
OOOOOOOOOOOOOOOXOXXX
XXXOXXXXXXXXXXXXOXXX
XXXOXOOOOOOOOOOOOXXX
XXXOXXXXXXXXXXXOXXXX
XXXOOOOXXXXOOOXOXXXX
XXXXXXOXXXXOXOXOXXXX
XXXXXXOOOOOOXOXOXXXX
XXXXXXXXXXXXXOXOOOOO
XXXXXXXXXXXXXOXXXXXX
XXXXXXXXXXXXXOOOOOOO