12
20
64
64
XXXXXXXXXOOOOOOOOXXX
SXXXXXXXXXXXXXXXOXXX
OOOOOOXOOOOOOOOXOXXX
XXXOXXXXXXXXXXXXOXXX
XXXOXOOOOOOOOOOOOXXX
XXXOXXXXXXXXXXXOXXXX
XXXOOOOXXXXOOOXOXXXX
XXXXXXOXXXXOXOXOXXXX
XXXXXXOOOOOOXOXOXXXX
XXXXXXXXXXXXXOXOOOOO
XXXXXXXXXXXXXOXXXXXE
XXXXXXXXXXXXXOOOOOOO