12
20
64
64
..2.................
613...611111111115..
2.....2..........2..
4118113..........2..
...2...61111111152..
...2...2........43..
6119...41111115.....
2..2..........2.....
411715........2.....
.....2........415...
.....41111115...2...
............41117111