12
20
64
64
XXSXXXXXXXXXXXXXXXXX
XXXXXXXXXXXXXXXXXXXX
XXXXXOXXXXXXOXXXXXXX
XXXXXXXXXXXXXXXXXXOX
XXOXXXXXXXXXXXXXXXXX
XXXXXXXXXOXXXXXXXXXX
XXXXXXXXXXXXXXXXXXXX
XXOXXXXXXXXOXXXXXXXX
XXXXXXXXXXXXXXXXXXXX
XXXXXXOXXXXXXXXXXXXX
XXXXXXXXXXXXXXOXXXOX
XXXXXXXXOXXXXXXXXXXE