12
20
64
64
....................
1111111111111111....
...............1....
....111111111111....
....1...............
....1111..11111.....
.......1..1...1.....
.......1111...1.....
..............1.....
..............1.....
..............111111
....................