12
20
64
64
....................
61111111111111111111
2...................
4111115.............
......2.............
......2.............
61115.411111115.6115
2...2.........413..2
411545.............2
...2.2........6115.2
...2.4111111113..413
1113................