12
20
64
64
....................
1111111111111115....
...............2....
....611111111113....
....2...............
....4115..61115.....
.......2..2...2.....
.......4113...2.....
..............2.....
..............2.....
..............411111
....................