12
20
64
64
....................
1111111111111115....
...............2....
..61111111111113....
..2.................
..2..61111115.......
..4113......2.......
.......611113.......
...61113............
...2....6111115.....
...2....2.....411111
...411113...........