12
20
64
64
.6111115.2..........
.2.....2.41115......
.2.....2.....411115.
.2.....2..........2.
.45....411111111113.
..45................
...45.....61115.....
....4115..2...2.....
.......2..2...2.....
.......4113...2.....
111111111111113.....
....................